+---------------+
│      XXI      │
│               │
│   The World   │
│               │
│   *           │
│               │
│    ,.-;;-. *  │
│   / ;;;'  \   │
│  |.   `:   |  │
│   \:    `;/ * │
│    '-..-''    │
│  *            │
│               │
│            *  │
+---------------+
